1111111111111111111
100E000010P00000001
111001111000C000011
1000000000000000111
100C00000000C000001
1000001101111100011
10000010C0000100001
1111111111111111111
